GENERALES

 DEROGACI흁: DEROGACI흁
 FIRMAS: FIRMAS
 LUC: LUC, LEY_DE_URGENTE_CONSIDERACI흁
 REFERENDUM: REFERENDUM, REFER텙DUM
 CAMPA헤: CAMPA헤

actores colectivos

 Cabildo Abierto: CABILDO_ABIERTO
 Comisi蚤 Nacional: COMISION_NACIONAL, PRO, PRO-REFERENDUM
 Fancap: FANCAP
 Fenapes: FENAPES
 Gobierno: GOBIERNO
 Intersocial Feminista: INTERSOCIAL_FEMINISTA, FEMINISTA
 MPP: MPP
 Organizaciones sociales: ORGANIZACIONES_SOCIALES
 Partido Colorado: PARTIDO_COLORADO
 Partido Comunista: PARTIDO_COMUNISTA
 Partido Independiente: PARTIDO_INDEPENDIENTE
 Partido Nacional: PARTIDO_NACIONAL
 PIT-CNT: PIT
 Universidad: UNIVERSIDAD
 FRENTE AMPLIO: FRENTE_AMPLIO

actores

 ABDALA: ABDALA
 ANDRADE: ANDRADE
 ARBELECHE: arbeleche
 ARGIM흁: ARGIM흁, ARGIMON
 ASTORI: ASTORI
 BERGARA: BERGARA
 CIVILA: CIVILA
 COSSE: COSSE
 DA_SILVA: DA_SILVA
 DA_SILVEIRA: DA_SILVEIRA
 DELGADO: DELGADO
 GANDINI: GANDINI
 HEBER: HEBER
 ITURRALDE: ITURRALDE
 JAVIER_GARC페: JAVIER_GARC페
 LACALLE: LACALLE
 LARRA헤GA: LARRA헤GA
 MANINI: MANINI
 MICHELINI: MICHELINI
 MIERES: MIERES
 MIRANDA: MIRANDA
 MUJICA: MUJICA
 ORSI: ORSI
 PACHA S쳁CHEZ: SANCHEZ, S쳁CHEZ
 PASSADA: PASSADA
 PEREIRA: PEREIRA
 SANGUINETTI: SANGUINETTI
 VALENTI: VALENTI

temas

 ADOPCIONES: ADOPCI흁, ADOPCION, ADOPCIONES
 ALQUILER: ALQUILER, ALQUILERES, INQUILINO, ARRENDATARIO
 ANCAP: ANCAP
 ANEP: ANEP
 ANTEL: ANTEL
 AUMENTO DE PENAS: PENAS, CONDENA
 COLONIZACI흁: COLONIZACI흁, COLONIZACION
 COMBUSTIBLE: COMBUSTIBLE, COMBUSTIBLES
 DELITO: DELITO, DELITOS
 EDUCACI흁: EDUCACI흁, EDUCATIVO, EDUCATIVA
 EMPRESAS_P２LICAS: EMPRESAS_P２LICAS, EMPRESA_P２LICA
 PANDEMIA: PANDEMIA
 PORTABILIDAD: PORTABILIDAD
 REGLA_FISCAL: REGLA_FISCAL
 SEGURIDAD: SEGURIDAD
 VIVIENDA: VIVIENDA
 LIBERTADES: LIBERTAD, LIBERTADES
 DERECHOS: DERECHOS, DERECHO 

